wwwwwwwwwwwwwwwwwwww
w..................w
w..................w
w..................w
w..................w
w.........wwwww....w
w....t....w---w....w
w.........w---w....w
w.........wwwww....w
w.................dw
w..................w
w............t.....w
w..................w
w..................w
wwwwwwwwwwwwwwwwwwww
