20 15 10 14
wwwwwwwwwwwwwwwwwwww
w..................w
w..................w
w..................w
w..................w
w..................w
w....t.............w
w..................w
w..................w
w..................w
w..................w
w............t.....w
w..................w
w..................w
wwwwwwwwwwwwwwwwwwww
