wwwwwwwwwwwwwwwwwwww
w..................w
w..................w
w..................w
w..................w
w.............wwwwww
w....t........w-----
w.............w-----
w.............wwwwww
w.................dw
w..................w
w............t.....w
w..................w
w..................w
wwwwwwwwwwwwwwwwwwww
